埃及总统承认俄A321飞机“被击毁”，224人死亡	承认	埃及总统	俄A321飞机
北海舰队紧急出动2艘军舰搜救青岛翻沉渔船	出动	北海舰队	军舰
中国军队人道主义援助物资顺利运交阿富汗
国防部回应裁军30万：将加大军队干部退役数量	回应	国防部	
国防部回应三沙军用机场部分改造为民用机场	回应	国防部	军用机场
解放军舰队护送商船航行，一周两次逼退可疑船只	护送	解放军舰队	商船
美坦克群在北极圈演练，准备对付俄军	在_演练	美坦克群	北极圈
美军在一周内两次试射洲际导弹，安抚日本别怕中国	试射_导弹	美军	
日菲签首个军备合作协议，特意强调不针对中国	签_合作_协议	日菲	
印度防展拒邀中国巴基斯坦展示技术，中国仍派代表团	拒	印度	中国巴基斯坦
哈马斯宣布对爆炸袭击负责	宣布_负责	哈马斯	
IS遭“恐怖袭击”，叙利亚头目被“基地”分支炸死
美逼土耳其弃导弹远离中国，欲再断丝路
中国首例燃烧器带压点火试验成功，填补国内空白	试验	中国首例燃烧器	
中国暗物质探测卫星启程运往酒泉，重达1.8吨	启程	中国暗物质探测卫星	酒泉
水炮成中国新杀手锏，美海警巡南海太荒唐
中国实现“不可能”任务，突破高能电磁发射技术	实现	中国	
台军装甲车冲进湖中沉没，士兵站车顶待援死亡	冲	台军装甲车	
中美两军神盾舰在大西洋联演
土耳其撕毁购买中国导弹合约	购买_中国导弹	土耳其	
中泰空军首次联训，歼-11和“鹰狮”同台竞技	联训	中泰空军	
中国“海巡01”轮赴西澳海域，继续相关搜寻任务	赴	中国“海巡01”轮	西澳海域
俄罗斯两艘新式攻击核潜艇年中将进行海上试航	攻击	俄罗斯两艘新式攻击核潜艇	中将
解放军今日至24日将在黄海进行2次例行性训练	在_进行_训练	解放军	黄海
伊朗建军节多个城市举行阅兵式，展示最新武器装备	举行_阅兵式	伊朗	
MH370搜寻重启，“蓝鳍金枪鱼”将加大潜水深度	搜寻	MH370	
英斥巨资打造电子边境项目，问题频出将被终
中国拓宽马航MH370失联客机搜索范围
中国海监1117船举行弃船演练，逃生必须带国旗	举行_演练	中国海监1117船	
难忘南沙琼台礁：中国海警船在南沙最南端执法	：	南沙	中国海警船
克里米亚乌克兰军事基地频遭袭，至少一人死
南苏丹暴徒袭击一联合国难民营地，致12人死亡	袭击	南苏丹暴徒	一联合国难民营地
叙利亚将登记总统候选人，估计阿萨德将轻松获胜	登记	叙利亚	总统候选人
中国沿海受威胁，日本战机到中国沿海仅需45分钟	威胁	中国沿海	
俄六架战略轰炸机连续5天分3条路线绕飞日本	分	俄六架战略轰炸机	日本
韩美联合军演今落下帷幕，半岛经历“紧张春季”	落	韩美	
遭“无数条”中国渔船袭击，40张渔网被捣烂
中国潜艇获重大突破，首次在一技术上超越美俄	突破	中国潜艇	
国际黑客组织向IS宣战，追击其每一个网络账户	向_宣战	国际黑客组织	IS
奥巴马宣布再赠菲二手巡逻船，保证南海航行自由	宣布	奥巴马	二手巡逻船
凤凰军评：巡洋舰伴航核航母，欧洲沦为俄反恐跟班
日本间谍卫星拟翻倍，分析称系日军事计划重要部分	分析	日本间谍卫星	
中国空军17日及时处置一起无人机“黑飞”问题	处置	中国空军	无人机
外交部：南海42岛被3国不法占据，中国有能力收回	收回	中国	
中国又被俄坑了？俄即将售华S-400性能缩水一半
官媒曝中国高能电磁武器，打出密集弹幕可反导	曝	官媒	中国高能电磁武器
日拟试射超音速反舰导弹，或针对中国新型神盾舰
中国侵入美政府网络使美损失巨额资金	侵入_网络	中国	美政府
第三届海鹰论坛移师深圳，研讨无人系统技术	研讨	第三届海鹰论坛	系统
1名外国间谍刺探解放军边境兵力分布，在吉林被擒	分布	解放军	
空警500核心技术完全国产化，突破“卡脖子”局面	突破	空警	
运20总设计师唐长红突然辞职，独家解析其去向	辞职	运20总设计师唐长红	
运-20总设计师与总工程师辞去在中航飞机公司职务	辞去	运-20总设计师	中航飞机公司
解放军新型“勇士”越野车定型，试车120万公里	试车	解放军新型“勇士”越野车	
英国拟投资防务1780亿英镑，购P8组建快反突击队	购P8	英国	
俄导弹地毯轰炸叙IS，逼欧洲脱美亲俄	轰炸	俄导弹	叙IS
中俄或联合改进24架苏-35，成中国定制版	改进	中俄	苏-35
印尼将参与韩国型战机开发项目，分担二成费用	参与	印尼	韩国型战机
首曝中国巨浪-2导弹，具备洲际射程携多弹头
美太平洋司令声称数周后将再次“巡航南海”	声称	美太平洋司令	
美军战略轰炸机拟进驻澳洲，对华构成掎角之势	进驻	美军战略轰炸机	澳洲
中国成功研制5千万亿瓦超强超短激光放大系统	研制	中国	激光放大系统
直18载C802守卫岛礁，伊朗妙想适用南海
中国高超音速武器今年第3次试验，进度超美	试验	武器	
一架战机在土叙边界叙利亚一侧坠毁	坠毁	土叙边界叙利亚	
中国第6次超高音速武器实验，美进度或落后	实验	中国第6次超高音速武器	
土击落俄战机或是精心策划，两国是历史宿敌	策划	俄战机	
俄罗斯会报复土耳其吗？看看当年苏巴空战历史吧	报复	俄罗斯	土耳其
“红脖子”参议员要求增强对台军售，不惜对华紧张	要求_增强	参议员	
2017号歼-20首飞仪式特殊隆重，或将进入小批量产	进入	2017号歼-20	
土总统3年前称闯入别国领空几秒，绝不是攻击借口	攻击	土总统	
伊朗最高领袖哈梅内伊赞普京：粉碎美在中东阴谋	：	伊朗最高领袖哈梅内伊	美
中国再射高超音速导弹，一小时内打遍全球	射_导弹	中国	
西方支持土耳其以显“团结”，同时又撇清关系	支持	西方	土耳其
美军黑鹰直升机胡德堡基地附近坠毁，机上4人丧生	坠毁	美军黑鹰直升机胡德堡基地附近	
中国在吉布提建军事基地，美专家认为合情合理	在_建_军事基地	中国	吉布提
俄在土边境不具空中优势，面对北约存致命短板
据《海洋法公约》，仲裁不影响中菲南海领土划界
中国重点型号军机应用自主研发新技术，国际先进	研发	军机	
中国新一代北斗卫星在轨测试，近万元器件自主研制	研制	中国	
俄大举轰炸，称已全歼坠机区恐怖分子和神秘团伙	称	俄	坠机区恐怖分子
习近平定调国防和军队改革，六大看点高屋建瓴	改革	军队	
俄军光荣级巡洋舰抵达叙海岸，打开S-300垂发系统	抵达	俄军光荣级巡洋舰	叙海岸
俄猎杀土库曼旅正副旅长，特种部队参战	参战	特种部队	
俄罗斯轰炸的“人道救援车队”真身到底是谁？	是	俄罗斯	
中国空军轰6K飞出第一岛链，巡航东海防空区	巡航	中国空军	东海防空区
俄军方：土耳其跟踪俄战机34分钟，战机空中埋伏	：	俄军方	土耳其
土击落俄机超出行为规范，是早有预谋	超出	俄机	
歼-31将主要用于出口，解放军也可能少量装备	用于	歼-31	
中国突破战略材料石墨烯，助力下一代发动机	突破	中国	
南海舰队舰艇代表直指6大问题，官兵脸红出汗	指	南海舰队舰艇代表	
三大舰队齐聚反潜合练，拱卫三亚航母基地安全	合练	三大舰队	
也门胡塞武装炮击沙特边境致1名军人2名平民死亡	炮击	也门胡塞武装	沙特边境
阿富汗副总统自封杀人博士，开坦克大战塔利班	自封	阿富汗副总统	博士
中国长征五号运载火箭合练箭在海南顺利转场	合	中国长征五号运载火箭	海南
长征七号在“亚洲第一高塔”开展全箭模态试验	开展	长征七号	
朝鲜潜艇在日本海试射失败，导弹未能出水	在_海试	朝鲜潜艇	日本
两岸首次秘密交换被俘情报人员	交换	两岸	被俘情报人员
一架俄罗斯战机误入以色列领空1.6公里	入	俄罗斯战机	以色列领空
青岛一网民捏造谣言严重损害海军形象声誉被查处	损害	网民	海军
越总理声称不谋求在南海扩军，欲平息中国“怒气”	声称	越总理	南海
火箭军十多发导弹齐射齐落，时间精度突破毫秒级	突破	火箭军	
联合国维和行动负责人将访华，讨论“借兵”八千	访华	联合国维和行动负责人	
中国战略核潜艇首航太平洋，对美发强烈信号	首航	中国战略核潜艇	太平洋
中国战舰编队在南海先后遭美日澳舰机跟踪尾随	遭_跟踪	南海	美日澳舰机
世界服役时间最长军舰，美国“宪法号”整修	整修	军舰	
俄专家：美军要用电磁炮对付中国？只是场心理战	对付	电磁炮	中国
中国海监直-9直升机舟山坠毁，4名机组人员遇难	坠毁	中国海监直-9直升机	
俄呼吁朝韩避免采取恶化局势的行动
巴基斯坦军方原则上同意购买8艘中国潜艇	同意_购买	巴基斯坦军方	中国潜艇
美国宣布与古巴建立外交关系	与_建立_外交_关系	美国	古巴
菲日大举加强军事合作抗衡中国
巴基斯坦政府决定为驻巴中国公司提供军事保护	为_提供军事保护	巴基斯坦政府	巴中国公司
美国会要求加强美台军事合作	加强_合作	美国会	
美教授独立日发文控诉美国不自由10宗罪	控诉	美教授	美国
埃及民众举行大规模反贪污游行要求解雇财政部长	要求_解雇	埃及民众	
非法“占中”冲击政府总部
日本大学生通过绝食抗议安倍政权	抗议	日本大学生	安倍
中国抵制日货	抵制	中国	
法国轮渡工人罢工致货车堵塞车龙绵延逾30公里	罢工	法国轮渡工人	
中国停飞或减少韩国航班	停飞_航班	中国	韩国
格鲁吉亚议会驱逐俄罗斯维和部队	驱逐	格鲁吉亚议会	俄罗斯维和部队
法国强制拆除加莱港非法移民营地	拆除	法国	加莱港非法移民营地
泰国总理承认政府海上放逐缅甸难民	放逐	政府	缅甸难民
塞拉利昂北部两个地区重新实施宵禁
阿富汗塔利班袭击北约营地	袭击	阿富汗塔利班	北约营地
日本将延长打击索马里海盗活动或再增1年(图)	将_打击	日本	索马里海盗
以色列军事打击叙利亚境内目标	打击	以色列	叙利亚境内
以色列继续加强封锁加沙难民营饮用水极度缺乏	封锁	以色列	加沙难民营
乌克兰政府军攻克斯拉维扬斯克市
以色列连续轰炸加沙动物园，动物接连死亡成干尸	轰炸	以色列	加沙
阿尔及利亚发生大规模种族冲突致22人丧生	发生_种族冲突	阿尔及利亚	
美国初步断定极端组织使用生化武器	使用_生化武器	极端组织	
欧洲为打击恐怖活动拟实行火车票实名制	打击	欧洲	
潘基文出席阅兵式	出席	潘基文	
新加坡启动“后李光耀时代”大选	启动	新加坡	
涉关税腐败引发众怒危地马拉总统被夺豁免权
第四次世界议长大会呼吁促进和平与可持续发展	呼吁_促进和平	第四次世界议长大会	
中老签署磨憨－磨丁经济合作区建设共同总体方案
“伊斯兰国”损坏叙利亚台德穆尔又一古迹	损坏	伊斯兰国	叙利亚台德穆尔
也门政府为收复全境做准备	收复	也门政府	
马里总统称赞阿尔及利亚为其和平进程发挥重要作用	称赞	马里总统	阿尔及利亚
北约在罗马尼亚成立多国部队东南欧指挥部	成立	罗马尼亚	多国部队东南欧指挥部
英拉再次出庭或被判入狱10年检方提交新证据	出庭	英拉	检方
缉曼谷爆炸案嫌疑人有功泰警方自奖8万美元
孟建柱会见哈萨克斯坦总统助理兼安全会议秘书叶尔梅克巴耶夫	会见	孟建柱	哈萨克斯坦总统助理
访德国前总理施罗德
中国驻俄大使表示中俄是战后国际新秩序的建设者与维护者	表示	中国驻俄大使	中俄
打击日本非法捕鱼，俄罗斯不手软！
美国总统奥巴马离任后计划暂未确定	确定	美国总统奥巴马	
专家称美总统竞选人对华措辞强硬忽视经济现实	称	专家	美总统竞选人
美海军陆战队举行海滩突击演习美防长观摩	举行_演习	美海军陆战队	
格鲁吉亚总理宣布重组内阁	宣布	格鲁吉亚总理	内阁
阿巴斯不谋求连任巴解组织执委会主席	不谋求	阿巴斯	巴解组织执委会主席
缅甸禁止一夫多妻批评者称涉嫌歧视少数族裔	禁止	缅甸	
美古恢复外交关系英语在古巴校园重现生机	恢复_外交_关系	美古	
俄开始军事介入叙危机？	介入	俄	叙
“难民列车”涌入德奥	涌入	难民	
美国宣布加大对北极安全投入以抗衡俄罗斯	宣布	美国	北极
中国海军152舰艇编队到访埃及	海军_编队_访	中国海军	埃及
日本逮捕《海豚湾》主演或因酒驾没带护照	逮捕	日本	
第四次世界议长大会呼吁促进和平与可持续发展	呼吁_促进和平	第四次世界议长大会	
奥巴马将访北极小镇徒步看正在消融的冰河	访	奥巴马	北极小镇
二战同盟国领袖为何同声赞誉中国	赞誉	二战同盟国领袖	中国
巴基斯坦军方空袭击毙至少31名武装分子	击毙	巴基斯坦军方	武装分子
４名土耳其警察在库工党武装袭击中死亡	死亡	土耳其警察	
危地马拉总统宣布辞职表示将不会寻求政治庇护	宣布_辞职	危地马拉总统	
法欲售“西北风”	售	法	
俄要搭售俄制机	搭售		俄
“博科圣地”杀害至少26人	杀害	博科圣地	
非盟部队遇袭致死数十士兵
索马里“青年党”袭非盟维和部队致50人亡	袭	索马里	非盟维和部队
北约在立陶宛正式成立指挥中心	成立	立陶宛	
法国证实留尼汪岛飞机襟翼属于MH370编号一致	证实	法国	留尼汪岛飞机
危地马拉前总统被捕待审	被捕	危地马拉前总统	
埃及军方空袭炸死１３名极端分子	空袭	埃及军方	
彭丽媛会见联合国教科文组织总干事博科娃和国际女童和妇女教育研讨班学员	会见	彭丽媛	联合国教科文组织总干事博科娃
英国首相卡梅伦表示英将再接收数千名难民	表示	英国首相卡梅伦	英
中国企业捐资修建纳米比亚“希望小学”	修建	中国企业	纳米比亚
印尼国企部长称仍将推进高铁建设	称	印尼国企部长	高铁
奥巴马称美将确保伊朗不拥有核武器	称	奥巴马	美
联合国气候谈判面临提速压力	谈判	联合国	
塔吉克斯坦恐怖袭击事件致8人丧生	致	塔吉克斯坦	
外国来宾盛赞中国大阅兵	盛赞	外国来宾	中国
塔吉克斯坦副防长发动恐袭已有8名军警丧生	恐袭	塔吉克斯坦副防长	
朴槿惠访问“大韩民国临时政府旧址”	访问	朴槿惠	
日本欲从太空监视海洋搜集中国在东海南海信息	监视	太空	中国
希拉里对邮件门表遗憾但拒不道歉支持率创新低	拒_不_道歉	希拉里	
玻利维亚士兵欲驾机偷运360公斤毒品被捕	被捕	玻利维亚士兵	
联合国2015年第三轮气候谈判闭幕	闭幕	联合国2015年第三轮气候谈判	
中东难民危机发酵多国放宽难民入境限制	放宽_限制	中东难民	难民
多国驻蓉领事四川藏区纪行
中国援助几内亚第25批医疗队抵达科纳克里	批	几内亚第25批医疗队	科纳克里
中国成武装无人机主要出口国令美国不安
伊斯兰国横行伊拉克挟持3500人为奴	横行	伊斯兰国	伊拉克
菲扩建距南沙160公里海军基地美日越军舰可停泊
印尼立法加强反恐禁参与海外极端组织公民回国	反恐	印尼	极端组织公民
俄罗斯将长期驻军叙利亚俄军人拥有完全豁免权	驻军	俄罗斯	叙利亚俄军人
IS突击叙利亚一城市掳走400名平民	突击	IS	叙利亚
菲海军最大万吨舰下水可用于南海争端	用于	菲海军	南海
菲律宾提议美菲共同巡航南海	巡航	菲律宾	南海
俄防空兵举行10场大军演S400S300同时出动	举行	俄防空兵	大军
美国特种部队进驻伊拉克助打“伊斯兰国”组织	进驻	美国特种部队	伊拉克
成都军区大批能战将校履新成空或正建制改革	改革	成都军区	
解放军战舰开进东帝汶港口	开进	解放军战舰	东帝汶港口
韩军陆空协同大演习最新坦克猛冲进河	协同	韩军	坦克
直击火箭军演习	演习	直击火箭军	
未来可发展攻击性较强的弹射起飞型航母
俄总理抨击西方制造“新冷战”:创造信任太艰难	抨击	俄总理	西方
中国海警船今年第5次巡航钓岛12海里驱离日船	驱离	钓岛	日船
土耳其将在索马里设军事基地对当地官兵进行反恐训练	在_进行_训练	土耳其	索马里
美日军舰在菲律宾海展示战力	展示	菲律宾	
韩启德会见尼泊尔前议长内姆旺	会见	韩启德	尼泊尔前议长内姆旺
萨德入韩就是挑战中国，中方不可能吞苦果	挑战	韩	中国
叙利亚反对派宣布接受停火协议停火时间为两周	宣布	叙利亚反对派	
驻韩大使强硬警告：萨德会让中韩关系瞬间化乌有	警告	驻韩大使	
中国在吉布提补给保障基地已开工建设	建设	基地	
奥巴马签新法案：美国隐私保护范围扩至盟国公民	签	奥巴马	
中国军工巨头海外爆买并购多架航空企业	并购	中国	
中国巨型巡逻船用“潜规则”逼美舰让路	让	中国巨型巡逻船	
中国军工巨头海外爆买西方忧技术外泄
印尼向南海纳土纳群岛增兵2倍	向_增兵	印尼	南海纳土纳群岛
越南购买20套以色列精确制导火箭炮防卫南沙岛礁	购买_以色列精确制导火箭炮	越南	
中国首个海外军事基地开工	开工	海外军事基地	
美军高层扬言调整兵力对付中国将针对南海开展行动	对付	美军高层	中国
解放军南部战区司令员维护南海权益是最重要使命	维护	解放军南部战区司令员	南海
美军加大对IS网络战力度遏制其扩张影响力	对_网络战	美军	IS
边防团演习组织宣誓暴露目标战场喊话无效果	宣誓	边防团演习组织	
也门军队攻占沙特军事基地缴获大批武器弹药	攻占	也门军队	沙特军事基地
中国战斗机险与无人机空中相撞距离仅数百米
中国新智能蒙皮技术或已实用比F-22先进一代
MH370失联事件的启示：不能再让另一架飞机消失	启示	MH370	
航发是试出来的前端工作任何虚假都将原形毕露
中国无人机型号数量超国外总和在世界很火爆
军迷拍歼20泄密：胜过美1年耗资800亿美元情报业
土耳其自研远程防空系统？“还能再抢救一下”	抢救	土耳其自研	
已有东风-21反舰导弹为什么还要发展东风-26？	发展		东风-21反舰导弹
走下神坛的苏-35：仅买24架是为弥补产能不足	买	苏-35	
两声枪响维族同事倒在地上满身鲜血	倒	同事	
恐暴份子藏匿棉花地中大刀擦着特警头皮掠过
传印度花巨资探歼-10机密欲抄袭其关键技术
巴基斯坦拒给枭龙配中国产发动机	拒	巴基斯坦	中国
美探讨采购200架下新一代轰炸机比计划多100架	采购	美	轰炸机
俄被击落战机部分残骸坠入土耳其导致2人受伤
普京大牌不多小牌不少土耳其总统怪论怎么解
凤凰军评：日本为反IS出血中东虚名取代亚洲雄心
土耳其机关算尽却“百密百疏”俄不会善罢甘休	算	土耳其	
藏在字面后的玄机：精读习近平主席军改讲话
歼-20试飞致成都巨响？战机性能或已相当可靠	试飞	歼-20	成都
谈中国海上霸权野心太可笑美国军事基地遍全球
民航局长率先试乘ARJ-21“领导先飞”树立信心	试	民航局长	
美军核弹部队仍用鼻祖级软盘每年维护花610亿	维护	美军核弹部队	
中国新一代导弹将使美航母处于次要地位	使	导弹	美航母
“爱国者”难挡中国导弹只能靠激光	靠	中国导弹	激光
美军痴迷反恐荒废主业坦克大赛输给预备役	反恐	美军	坦克
第2艘国产航母或用电磁弹射取决于最后决策	取决于	电磁弹射	
中美在灰色地带频繁交手美方先天不足	交手	中美	美方
中国不断获得尖端武器像科幻小说产物	获得	中国	尖端武器
自行火炮可自动修正仅中国能做到	修正	自行火炮	中国
印尼海军非法抓扣中国渔船使用机枪野蛮开火	扣_渔船	印尼海军	中国渔船
中国电磁弹射技术比肩美国用不用看决策	看	美国	
中国约有20枚东风5导弹一半是东风5B	有	中国	东风5导弹
在台湾当兵摸扫把的时间比摸枪的时间长
印度最大亚洲第二大军火库起火至17少名军人丧生	起火	亚洲	军人
第二艘国产航母立项内幕：总设计无电磁弹射	设计	国产航母	电磁弹射
美智库建议蔡英文裁撤台空军仅留F-16机队	建议_裁撤	美智库	蔡英文
中国阻止印度加入核供应国集团保持主导地位	阻止_加入_集团	中国	印度
南沙岛礁吹填技术申报60多项专利鸟飞来都不走了	吹	南沙岛礁	
印度重启藏南前沿机场军舰驶入南海停靠菲越基地	军舰_驶入	藏南前沿机场	南海
英媒：歼-20即将服役将助于缩小其与美军差距	服役	歼-20	美军
俄商业航天成西方“打工仔”中国直接掀桌子	掀	中国	
美日韩联合反导跟踪演习用一架战机模拟导弹	联合_演习	美日韩	
正是新老交替时中国海警还有很长的上坡路要走	还有	中国海警	
美媒盘点亚洲军队那些“不太著名”的军事装备
中国第十五批赴黎巴嫩维和部队组织应急防卫演练	批	中国	黎巴嫩维和部队
“基地”组织分支在叙崛起也想“建国”	崛起	叙	
巴基斯坦考虑五代机“鹘鹰”可能性很大	考虑	巴基斯坦	五代机
三菱向中国劳工谢罪赔款部分受害者不接受和解	向_谢罪	三菱	中国劳工
韩国防部：朝鲜潜射弹道导弹技术已取得一定进展	：	韩国防部	朝鲜
中国武器进口下降出口暴增自研能力提升	提升	中国武器	
被西方武器杀戮不如用中国武器自卫	杀戮	西方武器	中国武器
印度拟卖越南反舰导弹抗衡中国向南亚出口军备	拟_向_出口军备	中国	南亚
中国把美逼入窘境面临四选项都对华有利	逼	美	华
“阵风”刮来的钱法国去年军火出口额创纪录	创	法国	
印度海军航母维护时发生毒气泄漏致两死两入院	发生	印度海军航母	
美国成功发射一枚秘密间谍卫星增强美监控能力	成功_发射_卫星	美国	
运-20已完成研制工作有望年内正式服役	服役	运-20	
中国仅是地区性大国军力比美国差得远	是	中国	美国
波兰海军突击队配德制枪械
美军轰炸IS导弹上写“来自巴黎的爱”	轰炸	美军	IS导弹
北京军区组织医疗分队服务革命老区树起人民军医好样子	组织	北京军区	医疗分队
空军总医院与四季青医院联合举办“世界慢阻肺日”义诊活动	举办_活动	四季青医院	
巴基斯坦ZDK03预警机内部罕见曝光	曝光	巴基斯坦ZDK03预警机	
韩国即将量产105毫米卡车炮拟2017年列装	列装	韩国	
美国军舰访问上海	军舰_访问	美国	上海
美海军宙斯盾驱逐舰首访上海将与中国海军联合演练	与_联合_演练	上海	中国海军
美航母南海附近实战训练战机频繁起飞	起飞	战机	
歼11战机演习机库多到数不清	到	歼11战机	
印度大型军火库发生火灾导致17人遇难19人受伤
英国一架轻型飞机坠毁致2人死亡	坠毁	英国一架轻型飞机	
美军要用电磁炮对付中国？只是场心理战	对付	电磁炮	中国
美警察巡逻车装备精良全面配猎枪和步枪
伊拉克空军消灭“伊斯兰国”7名头目	消灭	伊拉克空军	
中国海军第二十二批护航编队访问坦桑尼亚	批	中国海军	护航编队
女空降兵背上百斤大半天下巴磕伞刀流血还跳伞
你没见过的战舰干扰弹发射瞬间
预备役步兵师为啥要研发机器人战士	研发	预备役步兵师	机器人战士
雷锋传人谢正谊开设雷锋班微博粉丝数百万	开设	谢正谊	
标兵霸气：驾驭8种车型操作36种通信装备
新兵3个月练成重机枪神枪手雨雾中28发命中19发	练	新兵	神枪手
重温入党仪式，这11名老党员平均党龄71年
智取日军据点，他们送去“铁元宵”和“长眠药”
小难民无处安放的童年
勇士军车走钢丝！看我军战士如何开卡车玩漂移
神兵从天而降！王牌38军特种兵伞降破袭敌后
斯诺登披露“棱镜”美前司法部长认为其有功有过	披露	斯诺登	
歼20尚未装备空军部队正试验和试飞	装备_空军	歼20	
马里维和营地遇袭已致1死3重伤驻有中国维和人员
喷火怒射！新疆边防官兵坐打高射机枪
中国能在未来10年内将航天员送上月球	送	中国	
歼10首席试飞员寻救命恩人29年前坠落云南大山	寻	歼10首席试飞员	救命恩人
一切为了老区人民——武警部队左权县精准扶贫记事	记事	武警部队左权县	
马里维和营区遇袭：中国蓝盔在坚守
解放军演习雨中打火箭炮	演习	解放军	火箭炮
提前领略中国095A核潜艇风采
中国第四支驻利比里亚维和警察防暴队展开应急处突演练	展开_演练	利比里亚维和警察防暴队	
俄罗斯大火箭发动机密密麻麻
由“死敌”到“伙伴”，美越军事合作能走多远	合作	美越	
欧洲导弹防御系统部署到家门口，俄罗斯怎么办	部署	欧洲导弹防御系统	
中国驻马里维和人员遇袭
还能再近吗？近距实拍武装直升机发射导弹瞬间	发射_导弹	武装直升机	
塔利班袭击阿富汗法院致９死１３伤	袭击	塔利班	阿富汗法院
泰国军警清剿南部激进武装	清剿	泰国	南部激进武装
鹰击天山！新疆军区武直19昼夜发射导弹	发射_导弹	新疆军区武直19	
美军航母舰员激情热舞
美媒盘点在亚洲那些“不太著名”的军事装备
“95后”消防战士火场单手拎出喷火煤气罐	出	消防战士	喷火煤气罐
美军飞行表演队2架战机坠毁	坠毁	战机	
中国军迷零距离参观美两栖战舰	参观	中国	美两栖战舰
中国军队工作组乘军机赶赴马里	乘	中国军队	军机
叙利亚中北部地区战事升温	升温	叙利亚中北部	
美海空军表演队同日坠机1架正为奥巴马演讲助兴	助兴	奥巴马	
空军首批“清华班”飞行学员即将加入战斗行列	批	空军	
俄罗斯年内为伊朗装备4个S300导弹营	装备_导弹	伊朗	S300导弹营
中国军队工作组抵达马里首都巴马科	抵达	中国军队	马里首都巴马科
印度北部发生暴力冲突造成至少２１人死亡
时隔逾50年澳大利亚越战老兵遗骸终“回家”	回家	澳大利亚	
孙建国会见澳大利亚国防军司令宾斯金	会见	孙建国	澳大利亚国防军司令宾斯金
孙建国会见印度尼西亚国防部长里亚米扎尔德	会见_国防部长	孙建国	印度尼西亚
韩最新型隐身护卫舰下水采用混合动力系统	下水	隐身护卫舰	动力系统
哈萨克斯坦不明身份人员与军方持枪互射6死多伤	持枪	军方	
国防动员，再不牵手大数据就晚了
解放军步兵转型特战兵组建无人机侦察队	组建	解放军	无人机侦察队
解放军陆海空联训常态化:轰炸机更“耳聪目明”
中国军队工作组在马里加奥展开工作	展开	马里加	
叙政府军首次攻入伊斯兰国老巢IS四面楚歌	攻	叙政府军	伊斯兰国老巢IS
孙建国会见老挝国防部副部长兼人民军总参谋长苏旺	会见	孙建国	老挝国防部副部长
中国首次举办联合国维和特派团高级官员培训班	举办	中国	联合国维和特派团高级官员
孙建国会见英国国防参谋长霍顿	会见	孙建国	英国
孙建国在香格里拉对话会上的演讲	演讲	孙建国	
哈萨克斯坦阿克托别市武器商店遭袭	袭	哈萨克斯坦阿克托别市武器	
策划|特技飞行哪家强:各国飞行表演队炫技掠影
外交部就香格里拉对话会涉南海航行和飞越自由问题答问	就_答问	外交部	香格里拉
广东中山边防支队联合驻地医院开展全国爱眼日知识宣传	开展	驻地医院	
美国向全体驻日海军官兵下达禁酒令还将限制外出	下达	驻日海军官兵	
斯里兰卡军火库爆炸致1人死	爆炸	斯里兰卡	
安倍指责驻日美军女兵酒驾事件“荒谬绝伦”	指责	安倍	驻日美军女兵
英国皇家海军摄影比赛最佳照片出炉	出炉	英国皇家海军	
外媒：美军研发新一代战略核潜艇耗资千亿美元	研发	美军	战略核潜艇
韩海军将进行“独岛防御演习”出动数艘水上舰艇	进行_演习	韩海军	
自觉看齐追随矢志改革强军——全军和武警部队改革强军主题教育活动全面展开持续升温	展开	武警部队	
法国男子持大量军火涉嫌欧锦赛前夜发动恐袭	恐袭	法国	
美防长谈及盟国唯独遗漏韩国被疑搞微妙心理战	谈及	美防长	韩国
把俄罗斯逼到墙角北约引爆“新冷战”？	逼	俄罗斯	北约
洪水围困珍宝岛官兵水中巡边升国旗
驻日美军横行日本自食其果	横行	驻日美军	日本
中国军队现有2882名官兵正在执行维和任务	执行	官兵	
千余名军校毕业学员长征路上练指挥学打仗	练	学员	
我国科学家发现新的抗乙肝病毒基因	发现	科学家	
“蓝色突击－2016”中泰海军陆战队联合训练圆满落幕	联合_训练	中泰海军陆战队	
直击中泰海军陆战队联训实兵实弹演练	演练	中泰海军陆战队	
海军与国际SOS等组织建立航空应急救援合作机制	与_合作	海军	SOS
“追梦起航——2016全国航空科普文化月”系列活动全景扫描
潘基文：尽管扩张行动受遏制IS对全球威胁仍严峻	威胁	IS	
韩军方送回越过“北方界线”的朝鲜渔船	送	韩军方	
中国有望造出全球最强大预警机或用俄伊尔96	有望	中国	预警机
以色列多兵种举行联合演习战车轰鸣炮声阵阵	举行_演习	以色列	
扫雷兵清理爆沟泥土，差点铲爆一颗雷！
“蓝色突击2016”中泰联训进行多兵种实兵实弹综合演练
德国狙击手隐藏力惊人据说99%的人找不到	找	德国	
当“粽子”遇上训练场江苏海警这样过端午
最后一只911搜救犬被安乐死消防员夹道送行
实拍4艘最新入役海警船056版和万吨大舰同时现身	现身	大舰	
日华媒：日韩慰安妇协议难解困局仍需正视历史	：	日华媒	日韩慰安妇
驻扎在艰苦地区的和平卫士——记中国赴南苏丹维和步兵营	赴	中国	苏丹维和步兵营
美军用“便宜弹”打普通恐怖分子用导弹炸头目	打	美军	恐怖分子
央视曝光东风21D导弹起竖画面	曝光	央视	东风21D导弹
解放军新成果助大容量数据传输速率提高40多倍
中俄军舰联航钓岛令安倍紧张日急召中国大使
日本出招离间中泰关系：欲阻止中泰军事交流	阻止	日本	中
中美最强神盾舰舱内设施谁更好
中国驻英大使呼吁通过协商谈判解决南海问题	呼吁	中国驻英大使	南海
印度航空母舰发生毒气泄漏事件造成两人死亡	发生	印度航空母舰	
美海军陷史上最大规模腐败丑闻
美国女子被控试图对华非法出口F22发动机技术	对_出口	美国	华
尼日利亚军方打死10名“博科圣地”武装分子
数千人“包围”在德美军基地抗议美军无人机戮害平民	抗议_戮害	德美军基地	美军无人机
陆军大型训练基地实现多军兵种油料联保	实现	训练基地	
维和烈士申亮亮火化家人曾准备让他维和回来就结婚	火化	维和烈士申亮亮	
日媒:中国大型海警船数超日本力量对比逆转
美军改革军人晋升制度试图留住优秀人才	试图	军人	
哈萨克斯坦击毙5名潜逃中的恐怖分子	击毙	哈萨克斯坦	恐怖分子
非盟驻索基地遇袭击毙上百名极端人员	袭击	非盟驻索基地	极端人员
三名男子彻夜狂欢搭错船漂到叙利亚被安置俄军基地
受伤回国维和战士杨占成伤情稳定已住院治疗
俄军苏27战机坠毁飞行员牺牲	牺牲	飞行员	
美发射侦察卫星全面监听各类电子信号	侦察	美	卫星
外观以假乱真！成都工匠打造歼15歼20模型	打造	成都	歼15歼20
美国军舰进黑海俄罗斯会怎么办？	军舰_进	美国	黑海俄罗斯
俄专家眼中的南海问题解决之道
塞拉利昂支持中国在南海问题上的立场	支持	塞拉利昂	中国
美国成功发射一枚秘密间谍卫星增强美监控能力	成功_发射_卫星	美国	
高原怒吼！空降兵大批速射迫击炮开火	速射	空降兵	
武警新臂章做手机壁纸，这种风格你喜欢吗？	做	武警	
美国奥兰多警方称酒吧枪手已身亡	称	美国奥兰多警方	枪手
美国奥兰多市发生枪击事件致数人受伤
日韩慰安妇协议难解困局日本仍需正视历史	正视	日本	
维和烈士申亮亮骨灰到达老家河南明日安葬(图)	到达	维和烈士	河南
国防科大青年人才群体平均年龄不到35岁
看图！狙击手为啥是两个人？
火箭军某导弹旅组建“蓝军”督导组专门“找茬”	组建	导弹旅	
我国成功发射第二十三颗北斗导航卫星
维和牺牲烈士申亮亮魂归故里	归	维和牺牲烈士	
